的	的 的话 的确
一	一 一个 一定 一些 一般 一样
了	了 了解 了不起
是	是 是否 是不是 是的 是以 是非
不	不 不能 不是 不同 不仅 不过
我	我 我们 我国 我军 我俩 我们俩
这	这 这个 这样 这些 这里 这时
在	在 在于 在内 在家 在场 在外
人	人 人们 人民 人类 人物 人员
有	有 有些 有关 有的 有人 有时
他	他 他们 他人 他俩 他家 他妈的
来	来 来说 来到 来看 来自 来源
个	个 个人 个体 个别 个性 个体经济
道	道 道德 道路 道理 道教 道士
你	你 你们 你们俩
大	大 大家 大量 大小 大学 大大
到	到 到了 到底 到处 到达 到来
着	着 着重 着急 着手 着呢 着想
就	就 就是 就要 就是说 就业 就算
上	上 上海 上面 上述 上去 上升
那	那 那么 那些 那个 那样 那里
也	也 也是 也许 也就是 也就是说 也好
说	说 说明 说话 说过 说法 说道
下	下 下来 下去 下面 下降 下午
出	出 出来 出现 出去 出发 出口
然	然 然后 然而
地	地 地方 地区 地位 地球 地上
中	中 中国 中心 中央 中间 中国共产党
看	看 看到 看见 看来 看出 看法
时	时 时候 时间 时期 时代 时刻
要	要 要求 要是 要素 要不 要紧
没	没 没有 没想到 没人 没法 没什么
天	天 天气 天津 天空 天下 天然
过	过 过程 过去 过来 过渡 过多
可	可 可以 可能 可是 可见 可以说
自	自 自己 自然 自由 自身 自我
子	子 子女 子弹 子孙 子弟 子宫
能	能 能够 能力 能量 能源 能否
还	还 还是 还有 还要 还不是 还原
之	之 之间 之后 之一 之中 之外
以	以 以后 以及 以上 以前 以来
去	去 去年 去世 去过 去掉 去路
好	好 好象 好像 好好 好处 好几
后	后 后来 后面 后者 后果 后期
为	为 为了 为什么 为主 为此 为止
都	都 都会 都市 都督
会	会 会议 会上 会计 会见 会场
里	里 里面 里边 里头 里根
心	心 心理 心里 心情 心理学 心中
得	得 得到 得出 得了 得以 得意
对	对 对于 对象 对方 对立 对待
身	身 身体 身上 身子 身边 身份
手	手 手段 手里 手中 手术 手法
起	起 起来 起义 起源 起到 起伏
小	小 小时 小说 小组 小学 小姐
想	想 想到 想起 想象 想法 想不到
只	只 只有 只是 只要 只能 只好
而	而 而且 而是 而已 而后 而言
和	和 和平 和谐 和尚 和气 和睦
头	头 头上 头发 头脑 头部 头顶
她	她 她们
无	无 无产阶级 无法 无论 无数 无限
力	力 力量 力学 力气 力求 力图
面	面 面前 面积 面对 面貌 面临
如	如 如果 如何 如此 如今 如下
现	现 现在 现象 现代 现实 现代化
什	什 什么 什么样
样	样 样子 样品 样式 样儿 样本
多	多 多少 多么 多种 多数 多次
已	已 已经 已知
知	知 知道 知识 知识分子 知觉 知名
经	经 经济 经过 经验 经营 经常
声	声 声音 声明 声响 声调 声波
前	前 前面 前进 前提 前后 前者
神	神 神经 神秘 神话 神情 神圣
笑	笑 笑容 笑声 笑话 笑脸 笑嘻嘻
事	事 事情 事物 事实 事业 事件
开	开 开始 开展 开发 开放 开会
点	点 点头 点点头 点燃 点着 点心
方	方 方面 方法 方向 方式 方针
眼	眼 眼睛 眼前 眼泪 眼光 眼里
发	发 发展 发生 发现 发挥 发出
所	所 所以 所谓 所有 所在 所有制
但	但 但是 但愿
气	气 气候 气体 气温 气氛 气象
法	法 法律 法国 法制 法院 法规
意	意 意义 意见 意识 意思 意志
情	情 情况 情绪 情感 情形 情节
两	两 两者 两边 两国 两侧 两端
生	生 生产 生活 生命 生长 生物
家	家 家庭 家里 家伙 家乡 家长
间	间 间接 间隔 间隙 间断 间谍
将	将 将来 将军 将要 将近 将于
很	很 很多 很快 很少 很久 很有
真	真 真正 真的 真实 真理 真诚
话	话 话语 话剧 话题 话筒 话音
成	成 成为 成功 成立 成果 成分
让	让 让步 让给
被	被 被动 被迫 被子 被告人 被告
老	老 老师 老人 老头 老婆 老爷
动	动 动物 动作 动力 动机 动员
当	当 当时 当然 当前 当地 当作
用	用 用于 用来 用力 用不着 用以
于	于 于是 于右任
见	见 见到 见过 见面 见解 见于
回	回 回来 回答 回到 回家 回去
又	又 又是 又称 又名
军	军 军事 军队 军阀 军人 军官
把	把 把握 把戏
此	此 此外 此时 此后 此刻 此种
才	才 才能 才是 才行 才华 才干
几	几 几个 几乎 几十 几百 几千
战	战 战争 战士 战斗 战略 战胜
正	正 正确 正在 正是 正常 正式
龙	龙 龙国正 龙头 龙王
明	明 明显 明白 明确 明天 明亮
从	从 从而 从事 从来 从此 从前
却	却 却是 却说
长	长 长期 长江 长大 长度 长短
十	十 十分 十二 十一 十五 十九
三	三 三十 三角形 三中全会 三百 三千
女	女 女人 女儿 女子 女性 女士
光	光 光荣 光线 光辉 光明 光合作用
再	再 再也 再说 再次 再现 再生产
向	向 向前 向上 向着 向往 向来
实	实 实现 实际 实行 实践 实验
最	最 最后 最大 最近 最高 最好
行	行 行为 行动 行政 行业 行星
高	高 高兴 高度 高级 高低 高温
本	本 本身 本质 本来 本人 本领
打	打 打开 打击 打破 打算 打倒
定	定 定律 定义 定理 定额 定期
进	进 进行 进一步 进入 进步 进来
魔	魔 魔鬼 魔术师
风	风 风格 风俗 风险 风景 风暴
给	给 给予 给以 给出
问	问 问题 问道 问世 问候 问起
国	国 国家 国际 国民经济 国民党 国内
色	色 色彩 色素 色泽 色光 色调
同	同 同时 同志 同样 同学 同一
种	种 种子 种类 种植 种种 种族
走	走 走到 走进 走向 走出 走去
其	其 其他 其中 其它 其实 其次
年	年 年代 年轻 年龄 年前 年纪
口	口 口号 口气 口袋 口腔 口语
王	王 王朝 王国 王子 王明 王宫
怎	怎 怎么 怎样 怎么样 怎么办 怎能
边	边 边缘 边界 边境 边疆 边区
次	次 次数 次要 次序 次日 次年
全	全 全国 全部 全面 全体 全身
白	白 白色 白天 白云 白白 白纸
儿	儿 儿童 儿子 儿女 儿童文学
感	感 感到 感情 感觉 感染 感受
果	果 果然 果实 果树 果断 果园
听	听 听到 听说 听见 听得 听取
啊	啊 啊呀
体	体 体系 体现 体制 体育 体积
外	外 外国 外面 外部 外界 外交
死	死 死亡 死去 死后 死者 死刑
飞	飞 飞机 飞行 飞跃 飞到 飞船
分	分 分析 分别 分子 分布 分之
主	主 主要 主张 主义 主任 主体
觉	觉 觉得 觉悟 觉察 觉醒
住	住 住宅 住房 住在 住所 住处
少	少 少数 少年 少量 少数民族 少女
比	比 比较 比例 比赛 比如 比重
空	空 空气 空间 空中 空前 空军
因	因 因为 因此 因素 因而 因果
门	门 门口 门外 门前 门类 门户
等	等 等等 等于 等待 等到 等级
轻	轻 轻轻 轻松 轻工业 轻易 轻视
直	直 直接 直到 直线 直径 直觉
第	第 第一 第二 第三 第一次 第四
候	候 候选人
脸	脸 脸上 脸色 脸孔 脸蛋 脸颊
相	相 相同 相互 相当 相对 相信
强	强 强调 强烈 强度 强大 强迫
何	何 何况 何必 何以 何处 何等
张	张 张开 张学良 张作霖 张望 张口
快	快 快乐 快速 快要 快活 快去
做	做 做到 做好 做出 做法 做得
重	重 重要 重大 重视 重新 重点
与	与 与此同时 与其 与其说 与会
太	太 太阳 太太 太平洋 太多 太空
应	应 应该 应当 应用 应有 应付
刚	刚 刚才 刚刚 刚好
接	接 接受 接着 接触 接近 接过
位	位 位置 位于 位移
便	便 便是 便于 便宜 便利 便衣
量	量 量子力学 量子 量变
更	更 更加 更为 更是 更新 更有
难	难 难道 难以 难过 难得 难免
名	名 名字 名称 名词 名叫 名义
二	二 二十 二氧化碳 二者 二百 二十五
内	内 内容 内部 内在 内心 内地
连	连 连续 连忙 连接 连长 连队
水	水 水平 水分 水中 水里 水面
西	西 西方 西北 西南 西部 西欧
黑	黑 黑暗 黑色 黑格尔 黑龙江 黑人
马	马 马上 马克思主义 马克思 马路 马克思列宁主义
部	部 部门 部分 部队 部位 部长
入	入 入党 入手 入侵 入学 入伍
作	作 作用 作为 作品 作出 作家
兵	兵 兵力 兵士 兵团
师	师 师傅 师长 师生 师范 师资
虽	虽 虽然 虽说 虽则
别	别 别人 别的 别说 别看 别处
击	击 击败 击中
放	放 放下 放心 放出 放弃 放到
完	完 完全 完成 完整 完善 完了
四	四 四十 四人帮 四周 四川 四边形
灵	灵 灵魂 灵活 灵感 灵敏 灵活性
公	公 公司 公民 公里 公社 公开
并	并 并不 并且 并不是 并非 并存
先	先 先生 先进 先后 先是 先天
处	处 处理 处于 处在 处处 处境
士	士 士兵 士大夫
算	算 算是 算了 算出 算术 算什么
东	东 东西 东北 东方 东部 东南
机	机 机关 机会 机构 机械 机器
微	微 微笑 微微 微观 微生物 微弱
城	城 城市 城里 城镇 城乡 城内
火	火 火车 火箭 火焰 火柴 火星
变	变 变化 变成 变为 变动 变革
叫	叫 叫做 叫人 叫声 叫作 叫道
清	清 清楚 清晰 清醒 清朝 清晨
带	带 带来 带有 带领 带动 带到
杀	杀 杀死 杀人 杀害 杀菌
斯	斯 斯大林
李	李 李宗仁 李鹏 李大钊 李鸿章 李时珍
队	队 队伍 队长 队员 队里
云	云 云南 云雾 云层 云彩 云集
望	望 望远镜 望去 望见
原	原 原则 原来 原因 原子 原理
竟	竟 竟然 竟是
像	像 像是
惊	惊 惊人 惊讶 惊奇 惊异 惊醒
安	安 安排 安全 安慰 安静 安装
山	山 山东 山区 山上 山坡 山地
星	星 星期 星星 星期天 星际 星系
海	海 海洋 海水 海上 海面 海底
月	月 月亮 月份 月球 月光 月初
加	加 加强 加以 加工 加上 加入
金	金 金属 金融 金钱 金刚石 金牌
目	目 目的 目前 目标 目光 目的地
特	特 特别 特点 特征 特殊 特性
跟	跟 跟着 跟前 跟随 跟踪 跟上
场	场 场面 场所 场合 场上 场地
林	林 林彪 林业 林木 林子 林场
由	由 由于 由此 由此可见 由得 由衷
万	万 万物 万一 万分 万万 万里
美	美 美国 美丽 美元 美好 美术
任	任 任务 任何 任意 任命 任弼时
使	使 使用 使得 使劲 使命 使用价值
日	日 日本 日子 日益 日军 日常
立	立 立即 立刻 立场 立法 立方米
命	命 命令 命运 命题 命名 命脉
思	思 思想 思维 思考 思索 思想上
关	关 关系 关于 关心 关键 关怀
百	百 百姓 百万 百年 百分 百分比
转	转 转化 转移 转变 转身 转动
理	理 理论 理解 理想 理由 理性
常	常 常常 常见 常用 常有 常数
血	血 血液 血管 血缘 血压 血汗
受	受 受到 受伤 受过 受精 受热
离	离 离开 离子 离不开 离婚 离去
该	该 该书 该死 该项
界	界 界限 界线 界面
远	远 远远 远处 远方 远离 远大
平	平 平均 平衡 平等 平时 平原
阵	阵 阵地
物	物 物质 物体 物理 物资 物价
冷	冷 冷却 冷静 冷冷 冷笑 冷水
数	数 数量 数学 数字 数目 数据
信	信 信息 信仰 信号 信心 信任
刻	刻 刻苦 刻划 刻度 刻画
至	至 至于 至今 至少 至此 至多
突	突 突然 突出 突破 突变 突击
失	失 失去 失败 失望 失业 失调
怪	怪 怪物 怪不得 怪事
随	随 随着 随时 随便 随后 随意
五	五 五十 五月 五百 五千 五四
反	反 反映 反应 反对 反动 反复
找	找 找到 找出 找来 找着 找寻
似	似 似的 似乎 似地
许	许 许多 许可 许许多多 许久 许可证
般	般 般的
武	武 武器 武装 武汉 武力 武装力量
雷	雷 雷锋 雷达 雷雨 雷鸣 雷暴
非	非 非常 非洲 非法 非金属 非要
奇	奇 奇怪 奇迹 奇特 奇异 奇妙
通	通 通过 通常 通知 通讯 通电
解	解 解决 解释 解放 解放军 解除
绝	绝 绝对 绝不 绝大多数 绝大部分 绝望
怕	怕 怕是
精	精 精神 精神文明 精力 精确 精心
修	修 修改 修养 修理 修建 修正主义
暗	暗 暗暗 暗示 暗中 暗自 暗淡
满	满 满足 满意 满脸 满族 满怀
双	双 双方 双手 双眼 双重 双脚
度	度 度过 度数 度量
红	红 红军 红色 红旗 红楼梦 红光
半	半 半天 半年 半径 半岛 半殖民地
世	世 世界 世纪 世界观 世纪末 世代
始	始 始终 始于
倒	倒 倒是 倒霉 倒退 倒下 倒入
拉	拉 拉开 拉住 拉到 拉力 拉长
今	今 今天 今年 今后 今日 今晚
它	它 它们
落	落 落后 落实 落下 落到 落叶
攻	攻 攻击 攻克 攻势 攻占 攻打
学	学 学生 学习 学校 学者 学科
尔	尔 尔后
传	传 传统 传播 传来 传说 传递
音	音 音乐 音响 音节 音乐家 音调
指	指 指出 指导 指挥 指示 指标
路	路 路线 路上 路程 路子 路过
越	越 越来越 越南 越过 越是 越冬
表	表 表现 表示 表明 表面 表演
石	石 石油 石头 石块 石灰 石子
容	容 容易 容量 容器 容纳 容许
紧	紧 紧张 紧紧 紧密 紧急 紧接着
哥	哥 哥哥 哥白尼
合	合 合理 合作 合同 合成 合适
罗	罗 罗马 罗马尼亚 罗马帝国 罗盘
利	利 利用 利益 利润 利于 利息
冲	冲 冲突 冲击 冲动 冲破 冲出
步	步 步骤 步伐 步子 步兵 步枪
影	影 影响 影子 影片
姐	姐 姐姐 姐妹
伤	伤 伤心 伤害 伤员 伤口 伤亡
若	若 若干 若是
亲	亲 亲自 亲切 亲人 亲属 亲戚
功	功 功能 功夫 功率 功课 功绩
整	整 整个 整体 整理 整顿 整齐
弟	弟 弟弟 弟兄 弟子
丝	丝 丝毫 丝绸
吃	吃 吃饭 吃惊 吃完 吃力 吃饱
众	众 众多 众人 众所周知
花	花 花园 花朵 花色 花粉 花费
势	势 势力 势必 势能 势头 势力范围
早	早 早已 早就 早期 早晨 早在
哈	哈 哈哈 哈哈大笑 哈尔滨
帝	帝 帝国主义 帝国 帝王
流	流 流通 流动 流行 流传 流域
团	团 团结 团体 团长 团员 团委
青	青 青年 青少年 青春 青蛙 青年人
根	根 根据 根本 根据地 根本上 根源
极	极 极其 极为 极端 极力 极少数
静	静 静止 静脉 静悄悄 静态 静电
形	形 形成 形式 形象 形态 形势
即	即 即使 即可 即将 即是 即使是
深	深 深入 深刻 深深 深处 深度
周	周 周围 周期 周恩来 周年 周转
近	近 近代 近年来 近似 近来 近年
千	千 千万 千米 千方百计 千克 千百万
消	消 消灭 消费 消息 消耗 消失
结	结 结构 结果 结合 结束 结论
制	制 制度 制造 制定 制约 制成
干	干 干部 干什么 干涉 干扰 干燥
帮	帮 帮助 帮忙
速	速 速度 速率
性	性 性质 性格 性能 性状 性别
系	系 系统 系数 系列 系统性 系统论
言	言 言语 言论 言行
提	提 提高 提出 提供 提到 提倡
教	教 教育 教师 教学 教授 教会
皇	皇 皇帝 皇后 皇上 皇家
令	令 令人
文	文 文化 文学 文艺 文章 文字
雪	雪 雪白 雪花 雪山
谁	谁 谁知 谁知道 谁家
终	终 终于 终身 终年 终究 终生
必	必 必须 必然 必要 必需 必定
站	站 站起来 站在 站长 站住 站起身
化	化 化学 化合物 化合 化学反应 化石
哪	哪 哪里 哪儿 哪些 哪个 哪怕
破	破 破坏 破产 破裂 破旧 破烂
认	认 认为 认识 认真 认定 认识论
忙	忙 忙碌 忙于
往	往 往往 往来 往下 往前 往后
玉	玉 玉米 玉华
级	级 级差 级别
车	车 车间 车子 车站 车上 车辆
底	底 底下 底层 底部 底子 底片
总	总 总是 总结 总之 总理 总统
坐	坐 坐下 坐标 坐到 坐上 坐标系
巨	巨 巨大 巨额 巨型 巨人 巨浪
男	男 男女 男子 男人 男性 男孩
显	显 显然 显得 显著 显示 显微镜
克	克 克服 克制 克西
各	各 各种 各个 各地 各国 各级
新	新 新闻 新鲜 新兴 新疆 新型
斗	斗 斗争 斗志
急	急 急忙 急剧 急需 急性 急于
切	切 切实 切断 切线 切割 切身
阳	阳 阳光 阳台 阳性
叶	叶 叶子 叶片 叶绿素 叶倩倩 叶绿体
领	领 领导 领域 领导者 领袖 领土
收	收 收入 收到 收购 收集 收缩
衣	衣 衣服 衣裳 衣着 衣襟 衣袋
敢	敢 敢于
异	异 异常 异性 异样 异化 异物
围	围 围绕 围剿 围攻 围墙 围住
达	达 达到 达成 达尔文 达斡尔
象	象 象是 象征 象征性
错	错 错误 错综复杂 错觉 错过
服	服 服务 服从 服装 服务员 服饰
慢	慢 慢慢 慢性 慢吞吞
保	保 保证 保持 保护 保存 保障
办	办 办法 办公室 办事 办理 办公
活	活 活动 活跃 活泼 活力 活性
喜	喜 喜欢 喜爱 喜悦 喜剧 喜鹊
片	片 片面 片刻 片面性 片断 片子
杨	杨 杨勇 杨柳 杨虎城
兴	兴 兴趣 兴奋 兴起 兴建 兴办
刀	刀 刀子
摇	摇 摇头 摇摇头 摇晃 摇动 摇摆
准	准 准备 准确 准则 准是 准确性
夜	夜 夜里 夜晚 夜间 夜色 夜空
拿	拿 拿出 拿起 拿来 拿到 拿去
电	电 电子 电流 电视 电话 电影
交	交 交换 交通 交流 交给 交际
条	条 条件 条例 条约 条款 条件反射
朝	朝 朝鲜 朝着 朝廷 朝代
华	华 华北 华侨 华盛顿 华丽 华南
管	管 管理 管辖 管道 管子 管理者
断	断 断定 断言 断绝 断裂 断开
决	决 决定 决不 决心 决策 决议
尽	尽 尽管 尽量 尽可能 尽快 尽力
苦	苦 苦难 苦恼 苦笑 苦闷 苦痛
依	依 依靠 依据 依然 依赖 依照
易	易 易于
八	八 八十 八路军 八月 八百 八旗
露	露 露出 露天
语	语 语言 语音 语法 语义 语言学
闪	闪 闪烁 闪电 闪光 闪闪 闪亮
冰	冰 冰川 冰雪 冰晶 冰山 冰块
足	足 足以 足够 足球 足足 足迹
记	记 记者 记忆 记载 记得 记录
德	德 德国 德育 德意志
响	响 响起 响应 响声 响亮
害	害 害怕 害虫
及	及 及其 及时 及早 及格
球	球 球形 球体
阿	阿 阿姨 阿拉伯 阿富汗 阿拉伯人 阿根廷
计	计 计划 计算 计算机 计划经济 计划生育
顿	顿 顿时
爱	爱 爱情 爱国 爱人 爱好 爱因斯坦
告	告 告诉 告别 告诫 告状 告辞
夫	夫 夫人 夫妻 夫妇
七	七 七十 七月 七五 七百
嘴	嘴 嘴里 嘴唇 嘴巴 嘴角 嘴上
器	器 器官 器材 器械 器乐 器具
圣	圣 圣经 圣人 圣地
南	南 南京 南方 南部 南北 南极
留	留 留下 留给 留学 留心 留学生
元	元 元素 元旦 元年 元代 元件
敌	敌 敌人 敌对 敌军 敌后 敌我
沉	沉 沉重 沉默 沉思 沉淀 沉积
请	请 请求 请示 请来 请教 请问
官	官 官员 官僚 官兵 官吏 官僚主义
威	威 威胁 威信 威力 威严 威风
每	每 每个 每天 每年 每次 每人
况	况 况且
确	确 确定 确实 确立 确切 确是
答	答 答应 答案 答道 答复
陈	陈 陈毅 陈旧 陈二虎 陈述 陈列
宝	宝 宝贵 宝贝 宝石 宝库 宝座
视	视 视为 视觉 视野 视线 视察
护	护 护士 护理
格	格 格外 格局 格式
脑	脑 脑袋 脑子 脑海 脑筋 脑力劳动
兄	兄 兄弟 兄妹
狂	狂 狂风 狂热
淡	淡 淡淡 淡水
识	识 识别 识字 识记
题	题 题材 题目 题为 题词
停	停 停止 停留 停顿 停住 停下来
司	司 司机 司令 司法 司令部 司令员
低	低 低于 低温 低声 低头 低级
雨	雨 雨水 雨点 雨季 雨量 雨后
呼	呼 呼吸 呼唤 呼吁 呼喊 呼啸
久	久 久久 久而久之
未	未 未来 未能 未必 未曾 未经
孩	孩 孩子 孩儿
卫	卫 卫生 卫星
脚	脚 脚步 脚下 脚步声 脚印 脚上
除	除 除了 除去 除非 除夕 除此之外
古	古 古代 古老 古典 古人 古希腊
亚	亚 亚洲 亚里士多德 亚热带 亚运会
字	字 字母 字形 字眼 字样
骑	骑 骑兵 骑马
房	房 房子 房间 房屋 房里 房门
代	代 代表 代替 代谢 代价 代表团
伙	伙 伙伴 伙计 伙食
鬼	鬼 鬼子 鬼神
缓	缓 缓慢 缓和 缓缓 缓解
复	复 复杂 复辟 复杂性 复制 复合
六	六 六十 六月 六百 六千
黄	黄 黄河 黄色 黄金 黄昏 黄土
装	装 装置 装饰 装备 装有 装上
居	居 居民 居住 居然 居于 居多
凌	凌 凌晨
米	米 米饭
恐	恐 恐怕 恐惧 恐怖 恐慌 恐龙
单	单 单位 单纯 单独 单一 单调
旁	旁 旁边 旁人 旁的
钱	钱 钱财
跑	跑 跑到 跑去 跑来 跑进 跑出
布	布 布置 布局 布满 布克 布景
或	或 或者 或是 或者说 或许 或者是
爷	爷 爷爷
玩	玩 玩具 玩笑 玩意 玩艺 玩弄
报	报 报告 报道 报纸 报刊 报酬
疑	疑 疑问 疑惑 疑心 疑虑
术	术 术语
隐	隐 隐藏 隐蔽 隐约 隐隐 隐瞒
欢	欢 欢迎 欢乐 欢喜 欢呼 欢快
章	章 章程 章太炎
差	差 差异 差别 差不多 差距 差点
挥	挥 挥手 挥发 挥动
父	父 父亲 父母 父子
句	句 句子 句法
待	待 待遇 待业
九	九 九月 九十 九点
派	派 派人 派出 派遣 派出所 派别
持	持 持续 持久 持有
类	类 类型 类似 类别 类比 类推
宇	宇 宇宙 宇航员 宇航 宇宙飞船
蓝	蓝 蓝色 蓝天
佛	佛 佛教 佛像 佛经
刘	刘 刘少奇 刘邦
忽	忽 忽然 忽视 忽略 忽听 忽地
怀	怀 怀疑 怀里 怀念 怀抱 怀孕
怒	怒 怒火 怒吼
掉	掉 掉下
招	招 招呼 招待 招生 招收 招手
希	希 希望 希腊 希特勒 希尔伯特
送	送 送到 送给 送来 送去 送进
背	背 背后 背景 背着 背上 背影
工	工 工作 工业 工人 工具 工厂
甚	甚 甚至 甚么 甚至于
烈	烈 烈士 烈火 烈日
卡	卡 卡车 卡片
细	细 细胞 细菌 细致 细节 细细
掌	掌 掌握 掌声 掌柜 掌柜的 掌管
论	论 论述 论文 论证 论点 论断
密	密 密切 密度 密集 密林 密封
运	运 运动 运用 运输 运动员 运行
退	退 退休 退出 退化 退回
酒	酒 酒精 酒杯 酒店
求	求 求证 求得 求出 求学
猛	猛 猛烈 猛地 猛然
另	另 另外 另一方面 另有
射	射 射线 射击 射出 射到 射电
集	集 集中 集体 集团 集合 集体所有制
首	首 首先 首都 首次 首长 首要
北	北 北京 北方 北部 北平 北京市
照	照 照片 照顾 照射 照着 照样
晚	晚 晚上 晚饭 晚期 晚年 晚会
赶	赶 赶紧 赶快 赶到 赶上 赶来
守	守 守恒 守卫 守法
木	木 木材 木板 木头 木质 木炭
散	散 散文 散步 散发 散射 散布
穿	穿 穿过 穿着 穿上 穿山甲 穿插
联	联 联系 联合 联想 联合国 联盟
铁	铁 铁路 铁匠 铁矿 铁器 铁丝
段	段 段祺瑞 段落
练	练 练习 练兵 练功
喝	喝 喝酒 喝水
需	需 需要 需求 需要量
支	支 支持 支配 支援 支出 支付
巴	巴 巴黎 巴西 巴掌 巴勒斯坦 巴基斯坦
左	左 左右 左手 左边 左脚 左侧
陆	陆 陆地 陆续 陆军 陆上
角	角 角度 角色 角落 角逐
书	书 书记 书籍 书面 书本 书写
防	防 防止 防治 防御 防守 防护
忍	忍 忍不住 忍受 忍耐 忍心 忍住
莫	莫 莫斯科 莫名其妙 莫非 莫大 莫不
群	群 群众 群体 群众性 群落 群众路线
民	民 民族 民主 民间 民兵 民众
客	客 客观 客人 客体 客观上 客厅
线	线 线段 线圈 线索 线条 线路
毫	毫 毫无 毫不 毫升 毫米 毫克
肯	肯 肯定
展	展 展开 展览 展现 展示 展出
谢	谢 谢谢 谢绝
亮	亮 亮子 亮光 亮相
痛	痛 痛苦 痛快 痛哭 痛心 痛恨
股	股 股票 股份 股长
造	造 造成 造型 造林 造就 造福
虎	虎 虎子
秦	秦 秦始皇 秦汉 秦国
紫	紫 紫色 紫外线 紫菜
宫	宫 宫廷 宫殿
激	激 激动 激烈 激发 激素 激起
赵	赵 赵紫阳 赵丹 赵强
渐	渐 渐渐
震	震 震动 震惊 震撼
注	注 注意 注视 注重 注意力 注入
禁	禁 禁止 禁不住 禁区 禁锢 禁忌
吸	吸 吸收 吸引 吸取 吸附 吸引力
取	取 取得 取消 取出 取决于 取代
梦	梦 梦中 梦想 梦境 梦幻 梦见
枪	枪 枪声 枪毙
程	程 程度 程序 程式
叹	叹 叹息 叹气
江	江 江南 江苏 江西 江青 江水
简	简 简单 简直 简称 简化 简便
羽	羽 羽毛
友	友 友谊 友好 友人 友爱
继	继 继续 继承 继而 继承人
念	念 念头 念书
右	右 右手 右边 右派 右脚 右派分子
热	热 热情 热烈 热量 热闹 热爱
份	份 份量
乐	乐 乐曲 乐器 乐队 乐观 乐意
压	压 压迫 压力 压强 压缩 压抑
既	既 既然 既是 既定
靠	靠 靠近 靠拢
香	香 香港 香烟 香味 香蕉 香气
恶	恶 恶劣 恶化 恶心 恶性 恶毒
引	引 引起 引导 引进 引力 引入
止	止 止住
包	包 包括 包含 包围 包装 包袱
追	追 追求 追逐 追究 追问 追赶
仅	仅 仅仅 仅仅是 仅有 仅次于
寒	寒 寒冷 寒风 寒潮
雅	雅 雅典
争	争 争取 争论 争夺 争吵 争议
愿	愿 愿意 愿望
超	超 超过 超越 超额 超出 超人
狠	狠 狠狠
厉	厉 厉害 厉声
式	式 式样
波	波 波动 波长 波兰 波斯 波浪
刺	刺 刺激 刺刀
号	号 号召 号称 号码
态	态 态度 态势
存	存 存在 存款 存放 存贮
游	游 游戏 游泳 游击队 游击 游行
台	台 台湾 台上 台风 台下 台阶
跳	跳 跳舞 跳跃 跳下 跳动 跳到
狼	狼 狼狈
属	属 属于 属性
妹	妹 妹妹 妹子
炼	炼 炼钢 炼丹
灭	灭 灭亡 灭绝
英	英 英国 英雄 英勇 英语 英文
醒	醒 醒来 醒目
举	举 举行 举办 举起 举动 举例
嘿	嘿 嘿嘿
境	境 境界 境内 境地 境遇
胜	胜 胜利 胜任 胜负 胜仗
诉	诉 诉讼 诉说
抱	抱 抱住 抱怨 抱歉 抱起
毕	毕 毕业 毕竟 毕业生 毕生
甲	甲 甲烷 甲板 甲状腺
齐	齐 齐全 齐声
拍	拍 拍摄 拍打
唐	唐 唐代 唐朝 唐太宗
君	君 君主 君子
楼	楼 楼上 楼房 楼梯 楼下
险	险 险恶
院	院 院子 院长 院里 院校
建	建 建立 建设 建筑 建议 建国
观	观 观察 观点 观念 观众 观测
柔	柔 柔软 柔和
逃	逃 逃避 逃走 逃跑 逃亡 逃出
置	置 置于 置身 置换
娘	娘 娘家
担	担 担任 担心 担负 担子 担保
阴	阴 阴谋 阴影 阴阳 阴沉 阴暗
呆	呆 呆呆 呆板
层	层 层次
试	试 试验 试管 试制 试图 试点
约	约 约束 约定
凡	凡 凡是
眉	眉 眉头 眉毛
弹	弹 弹性 弹簧 弹药 弹力
救	救 救国 救济 救命 救出 救灾
银	银 银行 银子 银幕 银河系
统	统 统一 统治 统计 统治阶级 统治者
否	否 否定 否则 否认
索	索 索性 索泓一 索马里 索取
抓	抓 抓住 抓紧 抓好 抓起 抓着
调	调 调节 调整 调查 调动 调查研究
曾	曾 曾经
基	基 基本 基础 基础上 基本上 基督教
顶	顶 顶点 顶端 顶上 顶着 顶部
苏	苏 苏联 苏维埃 苏州 苏军 苏区
图	图 图形 图画 图案 图象 图书馆
松	松 松树 松鼠 松弛 松软 松林
议	议 议论 议会 议员 议案
料	料 料到
顾	顾 顾客 顾问 顾虑 顾及 顾不上
严	严 严重 严格 严肃 严密 严厉
业	业 业务 业余 业绩 业已
恩	恩 恩格斯
礼	礼 礼貌 礼物 礼堂 礼仪 礼拜
耳	耳 耳朵 耳边 耳目 耳光
选	选 选择 选举 选手 选用 选出
余	余 余地 余立毅
败	败 败坏
区	区 区别 区域 区分 区长 区内
顺	顺 顺利 顺序 顺着 顺手 顺便
皮	皮 皮肤 皮鞋 皮质 皮下 皮带
沙	沙 沙漠 沙发 沙滩 沙俄 沙沙
瞬	瞬 瞬间
树	树 树立 树木 树上 树枝 树林
秘	秘 秘密 秘书 秘书长
商	商 商品 商业 商品经济 商店 商量
组	组 组织 组成 组合 组成部分 组长
汉	汉 汉语 汉族 汉字 汉子 汉奸
充	充 充分 充满 充实 充足 充当
贵	贵 贵族 贵州 贵重
迷	迷 迷信 迷人 迷惑 迷失
混	混 混合 混乱 混和 混淆 混战
纷	纷 纷纷
示	示 示威 示范 示意 示意图
伸	伸 伸出 伸手 伸长 伸展 伸向
助	助 助手 助长
封	封 封建 封建社会 封闭 封建主义 封锁
排	排 排列 排斥 排除 排出 排长
期	期 期间 期望 期限 期待 期货
肉	肉 肉体 肉眼 肉食
船	船 船舶 船长 船头 船只 船舱
座	座 座谈会 座位 座谈 座落
义	义 义务 义和团 义务教育
舰	舰 舰队
闻	闻 闻名 闻到 闻声
升	升 升高 升起 升华 升降 升到
室	室 室内 室温 室外
妈	妈 妈妈 妈的
亡	亡 亡国
付	付 付出 付款
控	控 控制 控告 控诉
警	警 警察 警惕 警告 警长 警报
负	负 负责 负担 负责人 负有 负荷
推	推 推动 推广 推行 推翻 推进
扬	扬 扬起 扬州
模	模 模式 模型 模糊 模仿 模范
凤	凤 凤凰
虚	虚 虚伪 虚构 虚假 虚心 虚实
默	默 默默
土	土 土地 土壤 土匪 土耳其 土地改革
技	技 技术 技巧 技能 技术改造 技术人员
费	费 费用 费尔巴哈 费力
温	温 温度 温暖 温柔 温和 温带
市	市 市场 市长 市委 市民 市区
麻	麻 麻烦 麻醉 麻雀 麻痹 麻木
初	初 初期 初步 初中 初级 初次
考	考 考虑 考察 考试 考虑到 考验
拥	拥 拥有 拥护 拥挤 拥抱
究	究 究竟
握	握 握手 握住
资	资 资本主义 资产阶级 资金 资源 资料
普	普 普遍 普通 普及 普遍性 普通话
翻	翻 翻译 翻身 翻滚 翻开 翻腾
察	察 察觉 察看
独	独 独立 独特 独自 独立性 独占
幸	幸 幸福 幸而 幸运 幸亏 幸好
舞	舞 舞蹈 舞台 舞剧 舞蹈家 舞姿
称	称 称为 称之为 称赞 称呼 称作
母	母 母亲 母体 母子 母鸡 母猪
暴	暴 暴露 暴力 暴动 暴雨 暴风雨
按	按 按照 按劳分配 按时 按钮 按着
孙	孙 孙中山 孙子 孙悟空 孙子兵法
睡	睡 睡觉 睡着 睡眠
改	改 改变 改革 改造 改善 改进
换	换 换上 换句话说 换来 换言之 换取
素	素 素质 素材 素养 素描
较	较 较为 较之 较量
具	具 具有 具体 具备 具体化
箭	箭 箭头
品	品 品种 品质 品德 品格 品尝
忘	忘 忘记 忘掉 忘却
状	状 状态 状况 状元
堂	堂 堂屋 堂堂
副	副 副业 副主席 副热带
承	承 承认 承担 承包 承受
野	野 野兽 野外 野蛮 野生 野心
锋	锋 锋利 锋芒
洞	洞 洞里 洞口 洞穴
遇	遇 遇到 遇见 遇上 遇着
查	查 查明 查出 查看 查处 查阅
洛	洛 洛阳
局	局 局面 局部 局长 局限 局限性
划	划 划分 划时代 划清 划定
权	权 权利 权力 权威 权益 权限
藏	藏 藏族
味	味 味道 味儿
丹	丹 丹麦
故	故 故事 故意 故乡 故障
钟	钟 钟头 钟声
坏	坏 坏人 坏事 坏蛋 坏死
仍	仍 仍然 仍是 仍旧
宗	宗 宗教 宗旨 宗法 宗教信仰 宗教改革
弱	弱 弱点
弄	弄 弄清 弄到
脱	脱 脱离 脱落 脱下 脱节 脱去
菲	菲 菲律宾 菲菲
胸	胸 胸前 胸脯 胸部 胸膛 胸口
药	药 药物 药品 药材 药水 药用
历	历 历史 历史上 历来 历代 历史唯物主义
徐	徐 徐徐 徐州 徐悲鸿
拳	拳 拳头
爆	爆 爆发 爆炸
杰	杰 杰出 杰作
谈	谈 谈话 谈到 谈判 谈起 谈论
坚	坚 坚持 坚决 坚定 坚强 坚硬
奥	奥 奥运会 奥秘 奥地利
仿	仿 仿佛 仿效
据	据 据说 据统计 据点 据此
偷	偷 偷偷
施	施 施工 施行 施肥 施用 施加
产	产 产生 产品 产量 产物 产业
营	营 营养 营业 营长 营造 营业员
骨	骨 骨干 骨头 骨骼 骨髓
晶	晶 晶体 晶莹
透	透 透明 透过 透镜 透露 透视
尊	尊 尊重 尊敬 尊严
短	短 短期 短短 短暂 短缺 短促
抬	抬 抬起 抬头 抬高
政	政 政治 政府 政策 政权 政党
烦	烦 烦恼 烦躁
河	河 河流 河南 河北 河水 河边
牙	牙 牙齿
维	维 维持 维护 维生素 维修 维新
证	证 证明 证实 证据 证书 证券
卷	卷 卷起
幽	幽 幽默 幽静
草	草 草原 草地 草案 草鞋 草木
森	森 森林
吴	吴 吴佩孚 吴刚 吴作人
摆	摆 摆脱 摆动 摆手 摆布 摆出
蒙	蒙 蒙古 蒙古族
危	危 危险 危机 危害 危急 危及
毒	毒 毒性 毒素 毒蛇 毒害 毒气
投	投 投资 投入 投降 投产 投机
熟	熟 熟悉 熟练 熟人 熟知
飘	飘 飘荡 飘来
导	导 导致 导演 导线 导体 导弹
朋	朋 朋友 朋友们
质	质 质量 质子 质变 质地 质朴
释	释 释放
喊	喊 喊道 喊声 喊叫
胡	胡 胡子 胡耀邦 胡适 胡须 胡说
参	参 参加 参与 参观 参考 参谋长
休	休 休息 休眠 休养
劲	劲 劲头
景	景 景象 景色 景物
挡	挡 挡住
印	印 印象 印度 印刷 印度洋 印第安人
幻	幻 幻想 幻觉
欲	欲 欲望
摸	摸 摸索 摸出 摸到
烟	烟 烟囱 烟雾 烟草 烟袋
致	致 致使 致病 致富 致死 致力于
尼	尼 尼龙
抗	抗 抗日 抗战 抗日战争 抗议 抗病
秋	秋 秋天 秋季 秋风 秋收 秋后
凝	凝 凝结 凝固 凝聚 凝视 凝神
寻	寻 寻找 寻求 寻觅 寻常
盘	盘 盘旋 盘子 盘算
永	永 永远 永恒 永久 永不
板	板 板凳 板块 板上
智	智 智力 智慧 智能 智育
责	责 责任 责任感 责任制 责备 责怪
尸	尸 尸体
柳	柳 柳青 柳树 柳条 柳州
临	临 临时 临床 临走 临近 临死
浪	浪 浪费 浪漫主义 浪花 浪漫 浪潮
恨	恨 恨不得
吓	吓 吓人 吓唬
价	价 价值 价格 价值规律 价钱 价值观
硬	硬 硬度 硬是 硬化 硬要
探	探 探索 探讨 探测器 探测 探求
横	横 横向 横行
标	标 标准 标志 标本 标题 标语
纳	纳 纳入 纳税 纳闷
欧	欧 欧洲 欧美 欧姆
宁	宁 宁静 宁可 宁愿 宁夏 宁肯
墙	墙 墙上 墙壁 墙角
田	田 田野 田地 田里 田间 田文中
习	习 习惯 习俗 习性 习惯于
肩	肩 肩膀 肩上 肩头 肩负
戏	戏 戏曲 戏剧 戏剧性 戏台
设	设 设备 设计 设立 设想 设置
效	效 效果 效率 效应 效益 效力
福	福 福建 福利 福州 福音 福气
移	移 移动 移植 移到 移民
型	型 型号
疯	疯 疯狂
毛	毛 毛泽东 毛主席 毛病 毛泽东思想 毛巾
贝	贝 贝多芬 贝壳 贝类
冒	冒 冒险 冒出 冒充
叔	叔 叔叔 叔同
碎	碎 碎片
轰	轰 轰动 轰轰烈烈 轰炸 轰鸣 轰击
扑	扑 扑来
奋	奋 奋斗 奋勇 奋力 奋战 奋起
饭	饭 饭店 饭碗 饭菜 饭馆 饭后
科	科 科学 科学家 科技 科研 科长
咱	咱 咱们 咱俩
治	治 治疗 治病 治理 治安 治好
湖	湖 湖南 湖北 湖泊 湖水 湖边
环	环 环境 环节 环流 环境污染 环绕
尘	尘 尘埃 尘土
略	略 略有 略带
躲	躲 躲避 躲到 躲开
免	免 免疫 免得 免费 免除 免不了
迎	迎 迎接 迎面 迎着 迎风 迎合
凭	凭 凭借 凭着 凭证
规	规 规定 规律 规模 规则 规范
犹	犹 犹如 犹豫 犹太人 犹太
雄	雄 雄伟 雄厚 雄壮 雄蕊 雄性
距	距 距离 距今
伯	伯 伯伯 伯父
借	借 借鉴 借助 借口 借助于 借款
床	床 床上 床前 床边 床头 床铺
骂	骂 骂人 骂道
朱	朱 朱德 朱占标
史	史 史料 史学 史岱年 史诗 史记
避	避 避免 避开
聚	聚 聚集 聚居 聚合 聚精会神
皱	皱 皱纹
秀	秀 秀丽 秀才
挑	挑 挑战 挑选 挑起 挑水 挑剔
降	降 降低 降水 降水量 降落 降到
敬	敬 敬爱 敬意 敬礼
源	源 源泉 源于
徒	徒 徒弟
束	束 束缚
鲜	鲜 鲜明 鲜血 鲜花 鲜艳 鲜红
撞	撞 撞击
岁	岁 岁月 岁时 岁数
架	架 架子
哭	哭 哭声 哭泣
袭	袭 袭击 袭来
罪	罪 罪恶 罪犯 罪行 罪名 罪过
节	节 节奏 节约 节目 节日 节省
罢	罢 罢了 罢工
食	食 食物 食品 食盐 食用 食堂
唯	唯 唯一 唯心主义 唯物主义 唯有 唯物辩证法
买	买 买卖 买来 买办 买到 买主
训	训 训练 训练班
腿	腿 腿上
稍	稍 稍稍 稍微
校	校 校长 校园 校舍
诺	诺 诺贝尔
某	某 某些 某种 某个 某部 某人
鲁	鲁 鲁迅
姑	姑 姑娘 姑姑
阻	阻 阻碍 阻止 阻力 阻挡 阻塞
丁	丁 丁字
闭	闭 闭上 闭合 闭幕
迅	迅 迅速 迅猛
逸	逸 逸出
残	残 残酷 残余 残废 残留 残暴
裂	裂 裂缝
托	托 托尔斯泰 托儿所 托人
良	良 良好 良心 良种 良性
泪	泪 泪水 泪珠 泪花
尖	尖 尖锐 尖端 尖刀 尖子
晓	晓 晓得
伊	伊 伊斯兰教 伊朗 伊拉克 伊犁
洋	洋 洋人 洋溢 洋流 洋铁桶
屋	屋 屋里 屋子 屋顶 屋内 屋外
尚	尚 尚未 尚不 尚书
颗	颗 颗粒
鱼	鱼 鱼类 鱼群 鱼种
炸	炸 炸弹 炸药
仇	仇 仇恨
讲	讲 讲话 讲究 讲到 讲过 讲述
配	配 配合 配套 配置 配备 配制
旧	旧 旧社会 旧式
绿	绿 绿色 绿化 绿叶 绿色植物 绿洲
假	假 假如 假设 假说 假定 假使
圆	圆 圆形 圆心 圆圆 圆圈 圆满
验	验 验证 验收
番	番 番茄
搞	搞 搞好 搞活 搞上去
迹	迹 迹象
荡	荡 荡漾
彩	彩 彩色 彩电
腾	腾 腾出
恢	恢 恢复
腰	腰 腰带 腰间
牛	牛 牛顿 牛奶 牛全德 牛肉 牛皮
吼	吼 吼叫
占	占 占有 占领 占用 占据 占优势
颤	颤 颤抖 颤动
趣	趣 趣味
梅	梅 梅花 梅兰芳
奔	奔 奔跑 奔驰 奔走 奔腾 奔去
愣	愣 愣住
勇	勇 勇敢 勇气 勇于 勇士
剩	剩 剩下 剩余价值 剩余 剩余产品
志	志 志气 志愿 志愿军 志向
舒	舒 舒服 舒适 舒畅 舒展
端	端 端正 端详 端起
医	医 医生 医院 医学 医疗 医药
炮	炮 炮弹 炮火 炮兵
蛋	蛋 蛋白质 蛋白
卖	卖 卖给 卖国
颜	颜 颜色 颜料
归	归 归纳 归结 归来 归根到底 归于
圈	圈 圈子 圈儿
限	限 限制 限度 限于 限期 限定
浮	浮 浮游 浮动 浮现
适	适 适应 适当 适用 适合 适宜
软	软 软弱 软件 软化
抵	抵 抵抗 抵制 抵抗力 抵达 抵押
厚	厚 厚度
尤	尤 尤其 尤为
广	广 广大 广泛 广州 广东 广阔
范	范 范围 范畴
桌	桌 桌上 桌子
欣	欣 欣赏 欣赏者 欣喜 欣慰
病	病 病人 病毒 病情 病理 病变
共	共 共同 共产党 共产主义 共有 共产党员
职	职 职工 职业 职能 职务 职责
诸	诸 诸如 诸葛亮 诸位 诸侯 诸多
镇	镇 镇压 镇上 镇静 镇定
专	专 专门 专业 专家 专政 专制
值	值 值得 值班 值钱
偏	偏 偏偏 偏见 偏离 偏向 偏差
杂	杂 杂志 杂交 杂质 杂草 杂文
增	增 增加 增长 增强 增大 增多
豪	豪 豪华 豪迈
咬	咬 咬住
触	触 触动 触及 触角 触犯 触发
陷	陷 陷入 陷于
挺	挺 挺进 挺拔
炎	炎 炎热 炎症
稳	稳 稳定 稳定性 稳固 稳步 稳重
巧	巧 巧妙
胖	胖 胖子
附	附 附近 附着 附加 附属 附有
盯	盯 盯住
碰	碰 碰到 碰上 碰撞 碰见
纪	纪 纪律 纪念 纪录
阶	阶 阶段 阶级 阶级斗争 阶层 阶级性
谷	谷 谷子 谷物 谷地
岛	岛 岛上 岛屿
夏	夏 夏季 夏天 夏克明
扫	扫 扫荡 扫除 扫描
潜	潜 潜力 潜在 潜伏 潜意识 潜入
毁	毁 毁灭 毁坏
项	项 项目
旋	旋 旋转 旋律 旋风
抢	抢 抢救 抢劫 抢先 抢险
抽	抽 抽象 抽出 抽烟 抽屉 抽象思维
优	优 优秀 优势 优良 优点 优美
涌	涌 涌现 涌起 涌出
网	网 网络 网点 网状
祖	祖 祖国 祖先 祖宗 祖父 祖母
拜	拜 拜访
测	测 测量 测定 测验 测出 测试
伟	伟 伟大
案	案 案件 案子
列	列 列宁 列入 列车 列为 列举
谓	谓 谓语
操	操 操作 操纵 操心 操场
春	春 春天 春秋 春节 春季 春苗
店	店 店里 店铺
瑞	瑞 瑞士 瑞典
善	善 善于 善良 善恶 善意
逼	逼 逼真 逼迫 逼近
浑	浑 浑身 浑浊
输	输 输入 输出 输送
烧	烧 烧毁 烧瓶
瞪	瞪 瞪大
懂	懂 懂得 懂事
富	富 富有 富裕 富于 富强 富农
汗	汗 汗水 汗珠
侧	侧 侧面 侧重
赤	赤 赤道 赤裸裸
率	率 率领 率先
杯	杯 杯子
京	京 京剧 京城 京师 京京
吉	吉 吉林
滚	滚 滚滚 滚动
浩	浩 浩瀚
获	获 获得 获取 获奖 获胜
轮	轮 轮船 轮廓 轮流 轮到 轮子
损	损 损失 损害 损伤 损耗 损坏
抖	抖 抖动
累	累 累计
讨	讨 讨论 讨厌 讨论会 讨好
苍	苍 苍白 苍蝇
悄	悄 悄悄 悄声
养	养 养成 养殖 养料 养分 养鱼
塞	塞 塞进
挂	挂 挂在 挂上 挂钩
胆	胆 胆子 胆怯 胆量
孤	孤 孤立 孤独 孤儿
陪	陪 陪着 陪同
镜	镜 镜头 镜子 镜面
凶	凶 凶手 凶恶 凶猛 凶狠
吐	吐 吐出
杜	杜 杜威 杜鹃 杜甫 杜文杰
猜	猜 猜想 猜测
庞	庞 庞大
拼	拼 拼命 拼音 拼搏
孔	孔 孔子 孔雀
盖	盖 盖上
材	材 材料
扎	扎 扎实 扎扎实实 扎根
爸	爸 爸爸
预	预 预测 预备 预防 预报 预先
晃	晃 晃动
姓	姓 姓名 姓氏
仔	仔 仔细
遍	遍 遍及 遍地 遍布
彻	彻 彻底
纯	纯 纯粹 纯洁 纯净 纯朴 纯收入
伦	伦 伦理 伦敦 伦理学
盗	盗 盗窃
愤	愤 愤怒 愤慨 愤恨
困	困 困难 困境 困苦 困惑
缘	缘 缘故
纵	纵 纵队 纵横 纵向 纵深 纵然
夺	夺 夺取 夺得 夺去 夺回
壁	壁 壁画 壁上
宋	宋 宋代 宋朝
估	估 估计 估算
介	介 介绍 介质 介于 介绍信
画	画 画家 画面 画出 画像 画法
庄	庄 庄稼 庄严 庄重 庄稼人 庄子
沈	沈 沈阳 沈括
补	补 补充 补偿 补贴 补给 补助
摩	摩 摩擦 摩擦力 摩托车 摩尔 摩尔根
脉	脉 脉搏
泰	泰 泰国
痕	痕 痕迹
燕	燕 燕子
折	折 折射 折磨 折腾 折旧 折断
演	演 演员 演出 演奏 演变 演化
灰	灰 灰色 灰尘
伏	伏 伏特
悠	悠 悠久 悠悠 悠闲
婆	婆 婆婆
创	创 创造 创作 创造性 创立 创新
研	研 研究 研制 研究所 研究生 研究者
含	含 含有 含量 含义 含蓄 含糊
写	写 写出 写作 写信 写成 写道
岳	岳 岳飞
午	午 午饭 午后 午夜 午餐
池	池 池塘 池水
睁	睁 睁开 睁大
萨	萨 萨满 萨满教
暂	暂 暂时 暂行
闲	闲 闲话 闲谈
概	概 概念 概括 概率 概括性 概况
逐	逐 逐渐 逐步 逐年
登	登 登记 登上 登陆 登载 登山
误	误 误差 误解 误会
戒	戒 戒指
村	村 村里 村庄 村子 村长 村落
街	街 街道 街上 街头
跃	跃 跃进
牌	牌 牌子
班	班 班长 班级 班主任 班子 班里
陛	陛 陛下
膀	膀 膀胱
迟	迟 迟疑 迟缓 迟到 迟钝 迟迟
替	替 替代 替换
谋	谋 谋生 谋略 谋求
伴	伴 伴随 伴奏 伴有 伴侣
霸	霸 霸占 霸权主义
怜	怜 怜悯
乌	乌 乌云 乌龟 乌黑 乌鸦 乌鲁木齐
曲	曲 曲线 曲折 曲子 曲调
瞧	瞧 瞧见 瞧不起
歌	歌 歌曲 歌声 歌唱 歌颂 歌舞
漂	漂 漂亮 漂移
嘻	嘻 嘻嘻
采	采 采取 采用 采访 采集 采购
昨	昨 昨天 昨晚 昨夜 昨日
互	互 互相 互助 互助组 互补 互为
舍	舍 舍不得 舍得 舍弃
慌	慌 慌忙 慌乱 慌张
糊	糊 糊涂
犯	犯 犯罪 犯错误 犯人 犯法
扭	扭 扭转 扭头 扭曲 扭动
判	判 判断 判决 判处 判定 判别
丢	丢 丢下 丢掉 丢失
羞	羞 羞愧
昏	昏 昏迷 昏暗
竹	竹 竹子 竹竿 竹林
唤	唤 唤起 唤醒
忧	忧 忧郁 忧虑 忧愁
锐	锐 锐利
琴	琴 琴声
宽	宽 宽阔 宽大 宽敞 宽度 宽广
莲	莲 莲子 莲花
躯	躯 躯体 躯干
疼	疼 疼痛 疼爱
剧	剧 剧本 剧烈 剧场 剧种 剧团
碧	碧 碧绿
征	征 征服 征收 征求 征税
鸟	鸟 鸟类
赞	赞 赞成 赞扬 赞美 赞叹 赞同
丈	丈 丈夫
漫	漫 漫长 漫画 漫步 漫不经心
缩	缩 缩小 缩短
帐	帐 帐篷
遭	遭 遭到 遭受 遭遇
坦	坦 坦克 坦白 坦率 坦然
喃	喃 喃喃
壮	壮 壮大 壮丽 壮观 壮族 壮烈
鼻	鼻 鼻子 鼻孔 鼻腔 鼻梁
聊	聊 聊天
怨	怨 怨恨
绕	绕 绕过
私	私 私人 私有制 私有 私营 私有财产
耀	耀 耀眼
财	财 财政 财产 财富 财务 财力
掩	掩 掩盖 掩护 掩饰
吞	吞 吞噬 吞食 吞下
织	织 织布 织云
监	监 监督 监视 监狱
洗	洗 洗澡 洗涤 洗脸 洗净 洗衣机
佩	佩 佩服
融	融 融合 融化 融洽
插	插 插入 插进 插上 插嘴 插图
梁	梁 梁启超
忠	忠 忠实 忠诚 忠于
悲	悲 悲剧 悲哀 悲惨 悲痛 悲伤
笔	笔 笔记 笔者 笔下 笔墨 笔直
迫	迫 迫切 迫使 迫害
凉	凉 凉爽
丫	丫 丫头
鼓	鼓 鼓励 鼓舞 鼓吹 鼓动 鼓起
亦	亦 亦即 亦可
敏	敏 敏感 敏锐 敏捷
狱	狱 狱中
召	召 召开 召集 召唤
博	博 博士 博物馆 博得
狐	狐 狐狸
吹	吹 吹来
拔	拔 拔出
荣	荣 荣誉 荣获
劳	劳 劳动 劳动者 劳动力 劳动人民 劳动生产率
茶	茶 茶叶 茶馆 茶杯 茶几
缠	缠 缠绕
盛	盛 盛行 盛有 盛开 盛大
磨	磨 磨损
浓	浓 浓度 浓厚 浓郁 浓缩 浓密
净	净 净化
仰	仰 仰望 仰起
遥	遥 遥远 遥感
废	废 废除 废物 废气 废墟
菜	菜 菜园
缺	缺 缺乏 缺少 缺点 缺陷 缺口
粗	粗 粗糙 粗暴 粗大 粗壮 粗略
躺	躺 躺下 躺在
宣	宣 宣传 宣布 宣言 宣扬 宣告
桑	桑 桑叶
惯	惯 惯性 惯例
遗	遗 遗传 遗产 遗留 遗憾 遗传学
执	执 执行 执政 执照
喷	喷 喷出 喷射
刹	刹 刹那间
努	努 努力
脆	脆 脆弱
耗	耗 耗费
窗	窗 窗外 窗户 窗口 窗子 窗前
积	积 积极 积累 积极性 积压 积雪
策	策 策略 策划 策动
辉	辉 辉煌
灯	灯 灯光 灯泡 灯火 灯笼 灯丝
辛	辛 辛苦 辛勤 辛亥革命 辛酸
援	援 援助
堆	堆 堆积 堆放
扶	扶 扶持
踏	踏 踏上 踏实 踏进
库	库 库存 库仑
屁	屁 屁股
奴	奴 奴隶 奴隶主 奴隶制 奴隶社会 奴役
熊	熊 熊熊
粉	粉 粉碎 粉末 粉红色
尾	尾 尾巴 尾部
批	批 批评 批判 批准 批发 批量
乖	乖 乖乖
趁	趁 趁着 趁机
爬	爬 爬上 爬到 爬行 爬行动物
隆	隆 隆重 隆起 隆隆
耐	耐 耐心 耐力
拖	拖 拖拉机 拖延
丰	丰 丰富 丰收 丰满 丰富多彩 丰产
码	码 码头
诚	诚 诚恳 诚实 诚然
律	律 律师
乃	乃 乃是 乃至
曹	曹 曹志道 曹操 曹英
岂	岂 岂不 岂不是
固	固 固定 固体 固然 固定资产 固有
洁	洁 洁白 洁净
社	社 社会 社会主义 社员 社会主义建设 社会主义社会
郭	郭 郭亮 郭沫若
骗	骗 骗人 骗子
滑	滑 滑动 滑稽
隔	隔 隔离 隔壁 隔绝 隔开
纸	纸 纸上 纸条 纸币 纸张
戴	戴 戴上
额	额 额头 额上 额定 额外
撤	撤 撤销 撤退
荒	荒 荒凉 荒地 荒唐 荒谬 荒山
季	季 季节 季度 季风 季节性
延	延 延长 延安 延伸 延续 延缓
旗	旗 旗帜 旗袍 旗号
撒	撒 撒谎
典	典 典型 典礼 典范
颇	颇 颇为
园	园 园林 园地
振	振 振动 振荡 振兴 振奋
仪	仪 仪器 仪式 仪表
省	省 省委 省市 省长 省城 省政府
猎	猎 猎人
跪	跪 跪下
抚	抚 抚摸 抚养
油	油 油画 油田 油灯 油脂 油菜
委	委 委员会 委员 委托 委屈 委员长
泉	泉 泉水
滴	滴 滴入
洪	洪 洪水 洪流
启	启 启发 启示 启蒙 启迪 启动
供	供 供应 供给 供求 供不应求 供销
拦	拦 拦住
祭	祭 祭祀
妻	妻 妻子
妇	妇 妇女 妇人
庆	庆 庆祝
婚	婚 婚姻 婚姻法 婚礼 婚后 婚事
牢	牢 牢固 牢牢
甘	甘 甘心 甘肃 甘蔗
奶	奶 奶奶 奶牛
径	径 径流 径直
倾	倾 倾向 倾斜 倾听 倾向性 倾诉
符	符 符合 符号
赌	赌 赌博
钻	钻 钻进 钻研 钻到 钻出
矮	矮 矮小
堡	堡 堡垒
宜	宜 宜昌
姿	姿 姿态 姿势
爽	爽 爽朗 爽快
堪	堪 堪称
焦	焦 焦急 焦点 焦虑 焦距 焦耳
零	零 零售 零件 零星 零下
薄	薄 薄弱 薄膜
扰	扰 扰乱 扰动
耶	耶 耶稣
牧	牧 牧场 牧草 牧师 牧民
朗	朗 朗诵
挣	挣 挣扎 挣脱
递	递 递给 递增
匆	匆 匆匆 匆忙
肖	肖 肖邦 肖武斌 肖像
亏	亏 亏损
燃	燃 燃烧 燃料 燃着
叛	叛 叛徒 叛乱 叛变
拒	拒 拒绝
肚	肚 肚子 肚皮 肚里
皆	皆 皆有
柱	柱 柱子 柱头
墨	墨 墨西哥 墨水
董	董 董事长 董事
莎	莎 莎士比亚
液	液 液体 液态 液化
途	途 途径 途中
岩	岩 岩石 岩层
芳	芳 芳香
慰	慰 慰问
户	户 户口
欺	欺 欺骗 欺负 欺侮
针	针 针对 针灸 针对性
扔	扔 扔下 扔掉
协	协 协调 协作 协议 协助 协会
驾	驾 驾驶 驾驭 驾驶员
享	享 享受 享有 享乐
郑	郑 郑重 郑州
赢	赢 赢得
珍	珍 珍贵 珍珠 珍惜
虫	虫 虫卵 虫子
康	康 康德 康有为 康熙
椅	椅 椅子
旅	旅 旅行 旅游 旅客 旅馆 旅长
货	货 货币 货物 货源 货款
减	减 减少 减轻 减弱 减小 减退
尝	尝 尝试 尝到
盈	盈 盈利 盈亏
餐	餐 餐厅 餐馆
埋	埋 埋怨 埋头 埋藏 埋伏 埋葬
抛	抛 抛弃 抛出
吻	吻 吻合
敲	敲 敲门
猫	猫 猫头鹰
侵	侵 侵略 侵犯 侵入 侵略者 侵蚀
弯	弯 弯曲 弯腰
茫	茫 茫然 茫茫
悔	悔 悔恨
喘	喘 喘息 喘气
勾	勾 勾结
哎	哎 哎呀 哎哟
截	截 截然不同 截至
舌	舌 舌头 舌尖
肃	肃 肃清
牵	牵 牵动 牵连 牵涉
例	例 例如 例子 例外 例证
庭	庭 庭院
彼	彼 彼此
氏	氏 氏族
夹	夹 夹杂 夹角
济	济 济南
吕	吕 吕布
渊	渊 渊源
卓	卓 卓越
甜	甜 甜蜜
笼	笼 笼罩 笼统
脖	脖 脖子 脖颈
爹	爹 爹妈
抹	抹 抹煞
艺	艺 艺术 艺术家 艺术品 艺人 艺术性
昂	昂 昂贵
哀	哀 哀求
末	末 末期 末端 末年 末了
奉	奉 奉献 奉命 奉行
劝	劝 劝说 劝告 劝阻
腹	腹 腹部 腹腔
钢	钢 钢铁 钢琴 钢材 钢笔
宏	宏 宏观 宏伟 宏观经济 宏大
挤	挤 挤出 挤满
鸿	鸿 鸿渐
核	核 核心 核算 核酸 核定 核准
猪	猪 猪肉
疾	疾 疾病
瓶	瓶 瓶子
僵	僵 僵化
乘	乘 乘机 乘客 乘坐
寂	寂 寂寞 寂静
粮	粮 粮食
聪	聪 聪明 聪明才智
诱	诱 诱导 诱发 诱惑 诱人
搭	搭 搭配
潮	潮 潮湿 潮流 潮水 潮汐
魏	魏 魏晋
鸡	鸡 鸡蛋
弥	弥 弥补 弥漫
瓦	瓦 瓦解
勉	勉 勉强
屈	屈 屈服 屈原
耸	耸 耸立
尺	尺 尺度 尺寸
喂	喂 喂养
丧	丧 丧失
悬	悬 悬挂 悬殊 悬浮 悬崖
拾	拾 拾起
晴	晴 晴朗 晴天
亿	亿 亿万
孟	孟 孟子
乔	乔 乔木
搜	搜 搜集 搜索 搜查
诗	诗 诗人 诗歌 诗意 诗句 诗经
偶	偶 偶然 偶尔 偶然性 偶像
均	均 均匀 均可 均衡 均为
童	童 童年 童话
覆	覆 覆盖
厌	厌 厌恶
悦	悦 悦耳
载	载 载体
掠	掠 掠夺 掠过
垂	垂 垂直 垂体 垂下
港	港 港口
袁	袁 袁世凯
衡	衡 衡量
构	构 构成 构造 构思 构图 构件
肌	肌 肌肉
词	词 词汇 词义 词语 词典 词组
纤	纤 纤维
脏	脏 脏腑
袖	袖 袖子
穷	穷 穷人 穷苦 穷尽
泥	泥 泥土 泥沙 泥浆 泥坑
驻	驻 驻地 驻扎 驻军
眸	眸 眸子
航	航 航行 航空 航海 航天 航线
辞	辞 辞职
乡	乡 乡村 乡镇企业 乡下 乡亲们 乡下人
催	催 催化剂 催促 催化
宿	宿 宿舍 宿主
慎	慎 慎重
魅	魅 魅力
凑	凑 凑近 凑巧
缝	缝 缝隙
歉	歉 歉意
授	授 授予 授权
映	映 映出
岸	岸 岸上 岸边
唱	唱 唱歌 唱腔 唱起 唱片 唱戏
崇	崇 崇拜 崇高 崇敬
读	读 读者 读书 读过 读到 读数
暖	暖 暖和 暖流
扩	扩 扩大 扩张 扩展 扩散 扩大再生产
狮	狮 狮子
瑶	瑶 瑶族
沿	沿 沿着 沿海 沿岸 沿途 沿用
渡	渡 渡过
稀	稀 稀少 稀疏 稀薄 稀释 稀有
恋	恋 恋爱
吩	吩 吩咐
笨	笨 笨重
返	返 返回
赖	赖 赖以
询	询 询问
斜	斜 斜面 斜坡
铺	铺 铺子 铺上 铺盖
咳	咳 咳嗽
尴	尴 尴尬
督	督 督促
奖	奖 奖励 奖金 奖章
卑	卑 卑鄙
染	染 染色体 染色 染上 染料
促	促 促进 促使 促成
弗	弗 弗洛伊德
泛	泛 泛滥
契	契 契约
罚	罚 罚款
埃	埃 埃及
课	课 课题 课程 课堂 课本 课文
屠	屠 屠杀
汇	汇 汇报 汇集 汇率
疗	疗 疗效 疗法
刑	刑 刑法 刑事 刑罚 刑事责任 刑事诉讼
夸	夸 夸张 夸大 夸奖
雕	雕 雕塑 雕刻 雕像
检	检 检查 检验 检讨 检举 检测
俗	俗 俗称 俗话说
俱	俱 俱乐部
摔	摔 摔倒
屏	屏 屏幕 屏上
麦	麦 麦子 麦加
闯	闯 闯进
予	予 予以
矿	矿 矿产 矿物 矿山 矿石 矿物质
恒	恒 恒星 恒定
呜	呜 呜呜
疲	疲 疲劳 疲倦 疲乏 疲惫
迈	迈 迈进 迈出
详	详 详细 详尽
巡	巡 巡视 巡逻 巡捕
滋	滋 滋味 滋润
婴	婴 婴儿
录	录 录音机 录取 录用
冠	冠 冠军
枝	枝 枝条 枝叶 枝上 枝头
翅	翅 翅膀
昆	昆 昆虫 昆明
矛	矛 矛盾 矛头
瘦	瘦 瘦弱
编	编 编制 编辑 编写 编成 编码
贪	贪 贪婪 贪污
繁	繁 繁殖 繁荣 繁多 繁重 繁华
绵	绵 绵羊
乾	乾 乾隆
拨	拨 拨款 拨乱反正
慈	慈 慈爱 慈祥 慈禧
咕	咕 咕咕
铃	铃 铃声
冯	冯 冯涛 冯玉祥 冯俭
允	允 允许
樱	樱 樱桃
愈	愈 愈来愈 愈加
宾	宾 宾馆 宾语 宾客
掏	掏 掏出
措	措 措施
农	农 农业 农民 农村 农产品 农场
糟	糟 糟糕 糟粕
捉	捉 捉住 捉摸
祝	祝 祝贺 祝福 祝月
咯	咯 咯咯
扮	扮 扮演
羊	羊 羊毛 羊群
驱	驱 驱逐 驱使
恰	恰 恰当 恰好 恰恰 恰巧 恰恰相反
梯	梯 梯度 梯形 梯田
裁	裁 裁判
咽	咽 咽喉
夕	夕 夕阳
幅	幅 幅度
扇	扇 扇子
崩	崩 崩溃
县	县 县委 县城 县长 县里 县政府
健	健 健康 健全 健壮 健美
箱	箱 箱子
恍	恍 恍然大悟 恍惚
捕	捕 捕捉 捕鱼 捕捞 捕食 捕获
育	育 育种 育苗
猴	猴 猴子
遮	遮 遮住
泡	泡 泡沫
扣	扣 扣除
溃	溃 溃疡
娃	娃 娃娃
评	评 评价 评论 评为 评选 评定
献	献 献身 献给 献出
涂	涂 涂上
序	序 序列
铜	铜 铜鼓
饮	饮 饮食 饮酒 饮水 饮料
灾	灾 灾难 灾害 灾区
湿	湿 湿润 湿度 湿热
冬	冬 冬季 冬天
贫	贫 贫困 贫农 贫下中农 贫穷 贫苦
汹	汹 汹涌
党	党 党委 党员 党中央 党支部 党内
棒	棒 棒槌
贯	贯 贯彻 贯穿 贯串
串	串 串联
丛	丛 丛林
棍	棍 棍子
嫁	嫁 嫁给 嫁接
肥	肥 肥料 肥沃 肥皂 肥大 肥力
穆	穆 穆斯林
挖	挖 挖掘
跌	跌 跌落
丑	丑 丑恶
赚	赚 赚钱
披	披 披上
漆	漆 漆黑
贺	贺 贺龙 贺诚
喉	喉 喉咙 喉头
酸	酸 酸性 酸碱
卧	卧 卧室
凄	凄 凄凉 凄惨
割	割 割据 割裂 割断
违	违 违反 违背 违法
裸	裸 裸露 裸体
井	井 井冈山
涨	涨 涨落 涨价
沐	沐 沐浴
仓	仓 仓库
宴	宴 宴会
饿	饿 饿死
鞭	鞭 鞭子 鞭炮 鞭策
瓜	瓜 瓜分
骚	骚 骚动
匪	匪 匪徒
耻	耻 耻辱
妄	妄 妄图 妄想
宛	宛 宛如
裤	裤 裤子
妥	妥 妥协 妥善 妥当
吵	吵 吵架 吵闹
驰	驰 驰骋
审	审 审美 审判 审查 审理 审批
款	款 款式
桥	桥 桥梁 桥头
诧	诧 诧异
搬	搬 搬到 搬家 搬运 搬来
仆	仆 仆人
漏	漏 漏斗
彭	彭 彭湃
灌	灌 灌溉 灌木 灌输
桃	桃 桃花 桃子
黎	黎 黎明 黎小玲
饱	饱 饱和 饱满
抑	抑 抑制 抑郁
辣	辣 辣椒
纠	纠 纠正 纠纷 纠缠
签	签 签订 签字
购	购 购买 购买力 购销 购置 购进
愚	愚 愚昧 愚蠢
勤	勤 勤劳 勤奋 勤工俭学
誉	誉 誉为
鄙	鄙 鄙视
珊	珊 珊瑚
呈	呈 呈现
培	培 培养 培育 培训 培植 培养基
牲	牲 牲口 牲畜
障	障 障碍 障碍物
锦	锦 锦标赛
瞳	瞳 瞳孔
析	析 析出
脾	脾 脾气
蓦	蓦 蓦地
嘲	嘲 嘲笑 嘲讽
毅	毅 毅然 毅力
僧	僧 僧侣
寺	寺 寺院
邀	邀 邀请 邀请赛
企	企 企业 企图 企业家
蜜	蜜 蜜蜂
骤	骤 骤然
频	频 频率 频繁 频频
挨	挨 挨打 挨着
蒋	蒋 蒋介石 蒋经国
植	植 植物 植株 植物体 植被 植树
厂	厂 厂长 厂里 厂房 厂家 厂矿
歪	歪 歪曲
拟	拟 拟定
丘	丘 丘陵
晋	晋 晋升
艰	艰 艰苦 艰难 艰巨 艰苦奋斗 艰辛
竞	竞 竞争 竞赛 竞选 竞技
涉	涉 涉及
谨	谨 谨慎
荷	荷 荷兰 荷花
跨	跨 跨进 跨过
舱	舱 舱里
颠	颠 颠倒 颠簸 颠覆
盒	盒 盒子
骄	骄 骄傲
柜	柜 柜台 柜子
摧	摧 摧毁 摧残
幼	幼 幼虫 幼儿 幼苗 幼年 幼儿园
谅	谅 谅解
哑	哑 哑剧
宰	宰 宰相
乳	乳 乳房 乳头 乳汁 乳白色
陌	陌 陌生 陌生人
竖	竖 竖起 竖直
销	销 销售 销售额 销路 销售量 销货
叮	叮 叮嘱
访	访 访问
沾	沾 沾满
挽	挽 挽救 挽回
堵	堵 堵塞 堵住
纱	纱 纱布
枯	枯 枯燥 枯竭
腐	腐 腐朽 腐蚀 腐败 腐烂
兔	兔 兔子
哗	哗 哗哗
绳	绳 绳子 绳索
搏	搏 搏斗
颈	颈 颈部
筹	筹 筹备 筹集 筹建
逝	逝 逝世
厨	厨 厨房 厨师
辅	辅 辅助 辅导
藤	藤 藤椅
盼	盼 盼望
矩	矩 矩形
膝	膝 膝盖
胳	胳 胳膊
墓	墓 墓地
畅	畅 畅销 畅通
擅	擅 擅自 擅长
冻	冻 冻结 冻疮
摊	摊 摊开 摊子
牺	牺 牺牲
淋	淋 淋巴 淋巴结
嚷	嚷 嚷嚷
涵	涵 涵义
灿	灿 灿烂
摄	摄 摄影 摄取 摄氏度 摄氏
削	削 削弱 削减
伪	伪 伪军 伪造
儒	儒 儒家
仲	仲 仲裁
瞄	瞄 瞄准
哨	哨 哨兵
羡	羡 羡慕
掀	掀 掀起 掀开
辽	辽 辽阔 辽宁
沟	沟 沟通 沟里
汽	汽 汽车 汽油
档	档 档案
隶	隶 隶属
描	描 描写 描述 描绘
俘	俘 俘虏
哲	哲 哲学 哲学家 哲理
赔	赔 赔偿
裙	裙 裙子
寿	寿 寿命
攀	攀 攀登
杆	杆 杆菌
旺	旺 旺盛
吾	吾 吾人
篮	篮 篮子 篮球
储	储 储存 储蓄 储备 储量
鉴	鉴 鉴定 鉴别 鉴于 鉴赏
嘀	嘀 嘀咕
赋	赋 赋予
炉	炉 炉子
呻	呻 呻吟
殷	殷 殷勤
污	污 污染 污水 污染物
辩	辩 辩证 辩证法 辩证唯物主义 辩护 辩论
篇	篇 篇章 篇幅
嗓	嗓 嗓子 嗓门 嗓音
播	播 播种 播放 播出
偿	偿 偿还
冤	冤 冤枉
俄	俄 俄国 俄罗斯 俄语
罕	罕 罕见
狡	狡 狡猾
蹲	蹲 蹲下
焕	焕 焕发
渴	渴 渴望
粒	粒 粒子
惩	惩 惩罚 惩办
患	患 患者 患病 患有
谦	谦 谦虚
汪	汪 汪精卫
辨	辨 辨别 辨认 辨证
歹	歹 歹徒
蕴	蕴 蕴藏
沸	沸 沸腾 沸点
陶	陶 陶冶 陶醉 陶瓷 陶器
迁	迁 迁移 迁徙 迁到 迁就
版	版 版画
咆	咆 咆哮
潇	潇 潇洒
鳞	鳞 鳞片
玫	玫 玫瑰
邓	邓 邓小平 邓颖超
侦	侦 侦察 侦查 侦探
炽	炽 炽热
竭	竭 竭力
讽	讽 讽刺
订	订 订货 订立
驳	驳 驳斥
拐	拐 拐杖
辜	辜 辜负
兼	兼 兼顾 兼任 兼并
吱	吱 吱吱
蓬	蓬 蓬勃
坡	坡 坡度
朴	朴 朴素 朴实
胎	胎 胎儿
苗	苗 苗木 苗族 苗子
遵	遵 遵守 遵循 遵照 遵义
浸	浸 浸润 浸泡
玻	玻 玻璃 玻璃窗
疏	疏 疏松 疏忽 疏远
瞎	瞎 瞎子
豆	豆 豆腐
廉	廉 廉价
祈	祈 祈祷 祈求
灼	灼 灼热
顽	顽 顽强 顽固 顽皮 顽固派
锅	锅 锅炉 锅里
榜	榜 榜样
庙	庙 庙宇
堕	堕 堕落
耽	耽 耽误 耽心
嗡	嗡 嗡嗡
挪	挪 挪威
鞋	鞋 鞋子
柴	柴 柴油机 柴可夫斯基
蔓	蔓 蔓延
姊	姊 姊妹
妨	妨 妨碍
盆	盆 盆地 盆景
矢	矢 矢量
携	携 携带
钉	钉 钉子
萝	萝 萝卜
循	循 循环
搅	搅 搅拌
渺	渺 渺小
狭	狭 狭窄 狭义 狭隘 狭小 狭长
申	申 申请 申诉
嘱	嘱 嘱咐
拆	拆 拆开
津	津 津津有味
愉	愉 愉快
谭	谭 谭嗣同
轨	轨 轨道 轨迹
媒	媒 媒介
锻	锻 锻炼
衷	衷 衷心
渗	渗 渗透 渗出 渗入
峡	峡 峡谷
禅	禅 禅宗
租	租 租界 租赁
阅	阅 阅读
帽	帽 帽子
揭	揭 揭示 揭露 揭开 揭发
乙	乙 乙醇 乙烯 乙炔
贸	贸 贸易
革	革 革命 革新 革命家 革命者 革命军
坎	坎 坎坷
舅	舅 舅舅
垃	垃 垃圾
寄	寄 寄生 寄托 寄主 寄生虫 寄来
虐	虐 虐待
逻	逻 逻辑 逻辑思维
税	税 税收 税金 税率
嫂	嫂 嫂子 嫂嫂
填	填 填补 填写 填充
滔	滔 滔滔
衍	衍 衍射
庸	庸 庸俗
寡	寡 寡妇
昔	昔 昔日
摘	摘 摘下
售	售 售价 售货员
栽	栽 栽培 栽植
贞	贞 贞观
臀	臀 臀部
雇	雇 雇佣
朦	朦 朦胧
栏	栏 栏杆
溪	溪 溪流 溪水
剥	剥 剥削 剥削阶级 剥夺 剥削者
磁	磁 磁场 磁力 磁铁 磁性 磁带
歼	歼 歼灭
窟	窟 窟窿
枕	枕 枕头
捣	捣 捣乱
乞	乞 乞丐
琢	琢 琢磨
胃	胃 胃口 胃肠
衰	衰 衰老 衰落 衰变 衰弱 衰退
扁	扁 扁担 扁平
菩	菩 菩萨
骆	骆 骆驼
纽	纽 纽约 纽带
贡	贡 贡献
喧	喧 喧闹
衙	衙 衙门
岗	岗 岗位
剂	剂 剂量
诞	诞 诞生
淘	淘 淘汰 淘气
衬	衬 衬衫 衬衣 衬托
轿	轿 轿车
钦	钦 钦佩
嗜	嗜 嗜好
鸦	鸦 鸦片 鸦片战争
陨	陨 陨石
咖	咖 咖啡
铸	铸 铸造
姥	姥 姥姥
棺	棺 棺材
叙	叙 叙述 叙事 叙利亚
畜	畜 畜牧业 畜牧
嫉	嫉 嫉妒
蜘	蜘 蜘蛛
钥	钥 钥匙
茅	茅 茅草 茅屋 茅盾
瘫	瘫 瘫痪
菊	菊 菊花
倘	倘 倘若
趋	趋 趋势 趋向 趋于
恳	恳 恳求
粘	粘 粘膜 粘液 粘土 粘性
哆	哆 哆嗦
渠	渠 渠道
娱	娱 娱乐
履	履 履行
塑	塑 塑造 塑料 塑像
症	症 症状
衔	衔 衔接
蔑	蔑 蔑视
傀	傀 傀儡
蒸	蒸 蒸发 蒸气 蒸汽机 蒸汽 蒸腾
炫	炫 炫耀
歧	歧 歧视
渔	渔 渔业 渔民 渔船 渔场
敞	敞 敞开
柏	柏 柏拉图 柏林
猿	猿 猿人
沮	沮 沮丧
惭	惭 惭愧
菱	菱 菱形
肿	肿 肿瘤 肿大 肿胀
茂	茂 茂密 茂盛 茂林
肺	肺 肺炎
淮	淮 淮河
拘	拘 拘留 拘束
漩	漩 漩涡
沼	沼 沼泽
侮	侮 侮辱
槐	槐 槐树
屡	屡 屡次
脊	脊 脊髓 脊柱 脊椎动物
贩	贩 贩卖
芦	芦 芦苇
淹	淹 淹没
嗅	嗅 嗅觉
邻	邻 邻居 邻近
妩	妩 妩媚
厦	厦 厦门
砖	砖 砖头
挫	挫 挫折 挫伤
杏	杏 杏仙
郊	郊 郊区
喇	喇 喇叭
沦	沦 沦为
蚂	蚂 蚂蚁
铲	铲 铲除
孕	孕 孕育 孕妇
敦	敦 敦煌
盐	盐 盐酸 盐水 盐类
鞠	鞠 鞠躬
桂	桂 桂林 桂英 桂花
呕	呕 呕吐
妓	妓 妓女
债	债 债务 债券 债务人 债权
窒	窒 窒息
蝙	蝙 蝙蝠
吭	吭 吭声
镰	镰 镰刀
饥	饥 饥饿
剔	剔 剔除
熄	熄 熄灭
蝴	蝴 蝴蝶
萌	萌 萌发 萌芽
绘	绘 绘画 绘制
侥	侥 侥幸
螺	螺 螺旋
聘	聘 聘请
唾	唾 唾沫 唾液
翡	翡 翡翠
苹	苹 苹果
脂	脂 脂肪 脂肪酸
宪	宪 宪法 宪兵 宪章
膨	膨 膨胀
葫	葫 葫芦
熔	熔 熔点 熔化
筷	筷 筷子
综	综 综合 综合性 综上所述 综合利用
傍	傍 傍晚
践	践 践踏
尿	尿 尿素
棉	棉 棉花 棉袄 棉衣 棉布 棉被
媳	媳 媳妇
坟	坟 坟墓
瀑	瀑 瀑布
逮	逮 逮捕
糖	糖 糖果 糖类
稻	稻 稻谷 稻田 稻草
狩	狩 狩猎
蚕	蚕 蚕丝
澄	澄 澄清
赠	赠 赠送
秩	秩 秩序
倔	倔 倔强
卵	卵 卵巢 卵细胞
胶	胶 胶体
绚	绚 绚丽
蚊	蚊 蚊子
罐	罐 罐头
冶	冶 冶金 冶炼
杭	杭 杭州
弊	弊 弊端 弊病
凳	凳 凳子
鲨	鲨 鲨鱼
盲	盲 盲目 盲目性
锡	锡 锡伯
伽	伽 伽利略
鸭	鸭 鸭子
滥	滥 滥用
驯	驯 驯服
拯	拯 拯救
绅	绅 绅士
匈	匈 匈牙利
钓	钓 钓鱼
缴	缴 缴纳
崎	崎 崎岖
谣	谣 谣言
栖	栖 栖息
棱	棱 棱镜
肝	肝 肝脏 肝炎
殖	殖 殖民地 殖民 殖民者
纲	纲 纲领
厘	厘 厘米
闺	闺 闺女
浇	浇 浇水
匀	匀 匀速 匀称
棚	棚 棚子
厕	厕 厕所
烙	烙 烙印
溶	溶 溶液 溶解 溶于 溶剂 溶化
虔	虔 虔诚
婶	婶 婶子
蠕	蠕 蠕动
拚	拚 拚命
惋	惋 惋惜
萎	萎 萎缩
殴	殴 殴打
澳	澳 澳大利亚 澳门
腊	腊 腊梅 腊月
昼	昼 昼夜
兑	兑 兑现
诊	诊 诊断
葡	葡 葡萄 葡萄糖 葡萄牙
蜡	蜡 蜡烛
慷	慷 慷慨
噪	噪 噪音 噪声
啤	啤 啤酒
洽	洽 洽谈
谬	谬 谬论
憔	憔 憔悴
酋	酋 酋长
框	框 框架
钞	钞 钞票
褐	褐 褐色
眺	眺 眺望
疙	疙 疙瘩
函	函 函数
睫	睫 睫毛
稿	稿 稿子 稿件
徘	徘 徘徊
芭	芭 芭蕾 芭蕾舞
嘈	嘈 嘈杂
崛	崛 崛起
缔	缔 缔结
鸽	鸽 鸽子
礁	礁 礁石
庐	庐 庐山
稠	稠 稠密
饵	饵 饵料
耕	耕 耕地 耕作 耕种
隧	隧 隧道
贷	贷 贷款
颁	颁 颁布 颁发
蘑	蘑 蘑菇
扼	扼 扼杀
唠	唠 唠叨
绒	绒 绒毛
邮	邮 邮票 邮电 邮局 邮政
煽	煽 煽动
矫	矫 矫正
吆	吆 吆喝
猖	猖 猖獗 猖狂
紊	紊 紊乱
亩	亩 亩产
舆	舆 舆论
锣	锣 锣鼓
鳄	鳄 鳄鱼
篝	篝 篝火
蛤	蛤 蛤蟆
荧	荧 荧光屏 荧光
氧	氧 氧气 氧化 氧化物 氧化剂 氧化铜
贬	贬 贬值
迂	迂 迂回
勘	勘 勘探
煤	煤 煤炭 煤矿 煤油 煤气
牡	牡 牡丹 牡蛎
屹	屹 屹立
肮	肮 肮脏
棕	棕 棕色
淤	淤 淤泥
浙	浙 浙江
俨	俨 俨然
暑	暑 暑假
雌	雌 雌雄 雌蕊
硝	硝 硝酸 硝酸钾
剖	剖 剖面 剖析
蜿	蜿 蜿蜒
蝗	蝗 蝗虫
谴	谴 谴责
刊	刊 刊物 刊登
巩	巩 巩固
踌	踌 踌躇
矗	矗 矗立
崭	崭 崭新
邯	邯 邯郸
奠	奠 奠定
辫	辫 辫子
鄂	鄂 鄂温克 鄂伦春
憧	憧 憧憬
铅	铅 铅笔
杠	杠 杠杆
饲	饲 饲料 饲养 饲养员
筛	筛 筛选
粪	粪 粪便
酝	酝 酝酿
柬	柬 柬埔寨
啄	啄 啄木鸟
羔	羔 羔羊
膳	膳 膳食
缅	缅 缅甸
乒	乒 乒乓球
榨	榨 榨取
辐	辐 辐射
螳	螳 螳螂
藻	藻 藻类
袜	袜 袜子
橡	橡 橡胶 橡皮
馒	馒 馒头
纬	纬 纬度
陕	陕 陕西 陕北
嫦	嫦 嫦娥
耷	耷 耷拉
琵	琵 琵琶
咀	咀 咀嚼
磷	磷 磷酸
孵	孵 孵化
濒	濒 濒临
诬	诬 诬蔑
阐	阐 阐述 阐明
辗	辗 辗转
锄	锄 锄头
颌	颌 颌骨
譬	譬 譬如 譬如说
烹	烹 烹调
炊	炊 炊事员
汲	汲 汲取
垄	垄 垄断 垄断资本
渲	渲 渲染
鲤	鲤 鲤鱼
螃	螃 螃蟹
渤	渤 渤海
碳	碳 碳酸钠 碳水化合物 碳酸钙
腼	腼 腼腆
椭	椭 椭圆形 椭圆
硫	硫 硫酸 硫酸铜
痉	痉 痉挛
蜻	蜻 蜻蜓
蔬	蔬 蔬菜
炕	炕 炕上
撰	撰 撰写
贮	贮 贮存 贮藏
咨	咨 咨询
倡	倡 倡导
淀	淀 淀粉
糯	糯 糯米
肾	肾 肾脏
纺	纺 纺织
胚	胚 胚胎
蚯	蚯 蚯蚓
榆	榆 榆树
惰	惰 惰性
柿	柿 柿子
摒	摒 摒弃
癌	癌 癌症
玳	玳 玳瑁
湍	湍 湍流
迄	迄 迄今
蜗	蜗 蜗牛
碉	碉 碉堡
抒	抒 抒情 抒发
侗	侗 侗族
摹	摹 摹仿
攫	攫 攫取
畸	畸 畸形
氢	氢 氢气 氢氧化钠 氢原子
哺	哺 哺乳动物 哺乳 哺育
僮	僮 僮族
荔	荔 荔枝
竣	竣 竣工
焊	焊 焊接
踊	踊 踊跃
砧	砧 砧木
抨	抨 抨击
碱	碱 碱性
氮	氮 氮气 氮肥
蝌	蝌 蝌蚪
肛	肛 肛门
孢	孢 孢子
诙	诙 诙谐
蔗	蔗 蔗糖
蟋	蟋 蟋蟀
耦	耦 耦合
鲫	鲫 鲫鱼
柑	柑 柑桔
缦	缦 缦杰
畲	畲 畲族
氯	氯 氯气 氯化钠 氯酸钾
傣	傣 傣族
疟	疟 疟疾
豌	豌 豌豆
氨	氨 氨基酸 氨水
缫	缫 缫丝
捍	捍 捍卫
著	著 著名 著作 著称 著述
